#######xx#######
#   ........TTT#
#..............#
#..............#
#..............#
#..............#
###..........###
x..............Q
x..............Q
###..........###
#..............#
#..............#
#..............#
#..............#
#..............#
#######xx#######
